11111111111111111111
10000000000000000001
10060000000000006101
10000000000000010101
10000000000003000401
10000000000000000001
10000000000000000001
10000000000000000001
10000000000000000001
10500000000000050001
10200000000000000001
10000000000000000001
10000000000000000001
10000000000000000001
11111111111111111111

//none=0/girder=1/playerSpawn=2/pusherSpawn=3/pusherEnd=4/bomb=5/endPoint=6